#
# 0 D Sala1.txt 1
# 1 D Sala1.txt 0 key1
# 2 E Sala2.txt 0
#
# k key2
#
WWWW0WWWWW
W        W
W        W
W        W
W        W
W   H  WWW
W      WkW
W      W W
W      W 1
WWWW2WWWWW