#
# 0 D Sala2.txt 1
# 1 D Sala4.txt 0 key2
#
WWWWWWWWWW
W        W
W  W  S  W
W  W     W
1  W     W
WWWWW    W
W  0W    W
W  WW    W
W      s W
WWWWWWWWWW